NO ./tex/crash_north.xpm
SO ./tex/crash_south.xpm
WE ./tex/crash_west.xpm
EA ./tex/crash_east.xpm

F 30,66,0
C 220,100,0

        1111111111111111111111111  111
        1000000000110000000000001  101
        101100000111000000S000001  111
        1001000000000000000000001
111111111011000001110000000000001
100000000011000001110111111111111
111101111111110111000000100011111
11110111111111011101010010001
11000000110101011100000010001
10000000000000001100000000001
10000000000000001101010000001
1100000111010101111101100000111
11110111 1110101 101111010001
11111111 1111111 111111111111