NO ./path_to_the_north_texture.xpm
SO ./path_to_the_south_texture.xpm
WE ./path_to_the_west_texture.xpm
EA ./path_to_the_east_texture.xpm

F 220,100,0
C 225,30,0

            11111111111111111111111111111
            10000000000000000000000000001
     111111110000111111111000000000000001
     100000000000100000001000000111111111
11111100001111000000100000010000000000001
10000000001000000000100000010111111110001
10001111111000011110100000010100000010001
10001000000000000000101111110100000010001
11111000000011111110101000000101111110001
10000000000010000000101000000100000000001
10000000011110001110101000000100000000001
10000000010000001000101000000101111100001
11111111010000001000101111111101000100001
10000000010000001000000000000001000100001
10000000011111111000000000000001111100001
10000000000000000000000000000000000000001
10000011000000000000000000000000000000001
10000010000000000000000000000000000100001
11111110111111111111111011111111110111111
10000000000000000000000000000000000100001
1000000000000000000000000000000N000100001
1111111111111111111111111111111111111111

