NO ./path_to_the_north_texture.png
SO ./path_to_the_south_texture.png
WE ./path_to_the_west_texture.png
EA ./path_to_the_east_texture.png

F 220,100,0
C 225,30,0

11111111111111111111111111111111111111111111111111111111111111111111111111111111
10000000111101110000000001111101000000001101111100000000111101110000000001111101
10N00000111101110000100001111111000000001101111100100000111111110000001001111101
10000000111101110000100001111111000000001101111100100000111111110000001001111101
10000000001000000000100000000010000000001000000000100000000010000000001000000001
10000000111101110000000001111101000000001101111100000000111101110000000001111101
11111101000000001101111100000000111101110000000001111101000000001101111100000001
11111101000000001101111100000000111101110000000001111101000000001101111100000001
10000000000000000000000000000000000000000000000000000000000000000000000000000001
11111101000000001101111100000000111101110000000001111101000000001101111100000001
11111101001000001101111100000010111101111000000001111101000010001101111100000001
11111101001000001101111100000010111101111000000001111101000010001101111100000001
10000000001000000000100000000010000000001000000000100000000010000000001000000001
10000000111101110000000001111101000000001101111100000000111101110000000001111101
10000000111101110000000001111101000000001101111100000000111101110000000001111101
10000000111101110000000001111101000000001101111100000000111101110000000001111101
10000000111101110000000001111101000000001101111100000000111101110000000001111101
10000000111101110000100001111111000000001101111100100000111111110000001001111101
10000000111101110000100001111111000000001101111100100000111111110000001001111101
10000000001000000000100000000010000000001000000000100000000010000000001000000001
10000000111101110000000001111101000000001101111100000000111101110000000001111101
11111101000000001101111100000000111101110000000001111101000000001101111100000001
11111101000000001101111100000000111101110000000001111101000000001101111100000001
10000000000000000000000000000000000000000000000000000000000000000000000000000001
11111101000000001101111100000000111101110000000001111101000000001101111100000001
11111101001000001101111100000010111101111000000001111101000010001101111100000001
11111101001000001101111100000010111101111000000001111101000010001101111100000001
10000000001000000000100000000010000000001000000000100000000010000000001000000001
10000000111101110000000001111101000000001101111100000000111101110000000001111101
10000000111101110000000001111101000000001101111100000000111101110000000001111101
11111111111111111111111111111111111111111111111111111111111111111111111111111111
